69Τ	TTATTACCGGATCCTCCGCTTATTGATATGC
70Τ	TTATTAGGCGATCCTCCGCTTATTGATATGC
71Τ	TTATTCTCCGATCCTCCGCTTATTGATATGC
3Y	TTATAGACCGATCCTCCGCTTATTGATATGC
5Y	TTATGTGACGATCCTCCGCTTATTGATATGC
6Y	TTATGAAGGGATCCTCCGCTTATTGATATGC
7Y	TTATGAGCTGATCCTCCGCTTATTGATATGC
1B	TTATGGTGTGATCCTCCGCTTATTGATATGC
2B	TTAATTCGCGATCCTCCGCTTATTGATATGC
3B	TTAATCCAGGATCCTCCGCTTATTGATATGC
7B	TTAATCGGTGATCCTCCGCTTATTGATATGC
8B	TTAATGTGGGATCCTCCGCTTATTGATATGC
9B	TTAATGCCTGATCCTCCGCTTATTGATATGC
13B	TTAATGGACGATCCTCCGCTTATTGATATGC
15B	TTAACTAGGGATCCTCCGCTTATTGATATGC
1K	TTAACAGTCGATCCTCCGCTTATTGATATGC
2K	TTAACCTTGGATCCTCCGCTTATTGATATGC
3K	TTAACCGAAGATCCTCCGCTTATTGATATGC
7K	TTAACGACAGATCCTCCGCTTATTGATATGC
8K	TTACTTACGGATCCTCCGCTTATTGATATGC
9K	TTACTTGTCGATCCTCCGCTTATTGATATGC
13K	TTACTAGAGGATCCTCCGCTTATTGATATGC
14K	TTACTCTGAGATCCTCCGCTTATTGATATGC