X7	TTCTCTGGCGATCCTCCGCTTATTGATATGC
X8	TTCTCCATCGATCCTCCGCTTATTGATATGC
X10	TTCTCCGCTGATCCTCCGCTTATTGATATGC
X11	TTCTCGTGAGATCCTCCGCTTATTGATATGC
X13	TTCTGTGTAGATCCTCCGCTTATTGATATGC
X14	TTCTGAACCGATCCTCCGCTTATTGATATGC
X16	TTCTGACGTGATCCTCCGCTTATTGATATGC
X17	TTCTGCTCAGATCCTCCGCTTATTGATATGC
X19	TTCATTGTGGATCCTCCGCTTATTGATATGC
X20	TTCATCTTCGATCCTCCGCTTATTGATATGC
X22	TTCATGTCAGATCCTCCGCTTATTGATATGC
X23	TTCAGTTACGATCCTCCGCTTATTGATATGC
X25	TTCAGTCCTGATCCTCCGCTTATTGATATGC
X26	TTCAGATTGGATCCTCCGCTTATTGATATGC
X28	TTCAGAAGAGATCCTCCGCTTATTGATATGC
X29	TTCAGCTGTGATCCTCCGCTTATTGATATGC
X31	TTCAGGCTAGATCCTCCGCTTATTGATATGC
X32	TTCCTTCATGATCCTCCGCTTATTGATATGC
X34	TTCCTAATGGATCCTCCGCTTATTGATATGC