X1	TTAGACTACGATCCTCCGCTTATTGATATGC
X2	TTAGACATGGATCCTCCGCTTATTGATATGC
X4	TTAGAGTCAGATCCTCCGCTTATTGATATGC
X5	TTAGCAGATGATCCTCCGCTTATTGATATGC
X37	TTAGCCTGTGATCCTCCGCTTATTGATATGC
X38	TTAGGTACAGATCCTCCGCTTATTGATATGC
X40	TTAGGCGCCGATCCTCCGCTTATTGATATGC
X41	TTCTTATGGGATCCTCCGCTTATTGATATGC
X43	TTCTTACTCGATCCTCCGCTTATTGATATGC
X44	TTCTTAGCAGATCCTCCGCTTATTGATATGC
X46	TTCTTCAGTGATCCTCCGCTTATTGATATGC
X47	TTCTTCGACGATCCTCCGCTTATTGATATGC
X49	TTCTTGAAGGATCCTCCGCTTATTGATATGC
X50	TTCTTGGTTGATCCTCCGCTTATTGATATGC
X52	TTCTATTCCGATCCTCCGCTTATTGATATGC
X53	TTCTATAGGGATCCTCCGCTTATTGATATGC
41T	TTCTAACAGGATCCTCCGCTTATTGATATGC
42T	TTCTACCGAGATCCTCCGCTTATTGATATGC
44T	TTCTAGTTGGATCCTCCGCTTATTGATATGC
45T	TTCTAGCCTGATCCTCCGCTTATTGATATGC
46T	TTCTAGGAAGATCCTCCGCTTATTGATATGC
48T	TTCTCTTAGGATCCTCCGCTTATTGATATGC
49T	TTCTCTACAGATCCTCCGCTTATTGATATGC
50T	TTCTCTCTTGATCCTCCGCTTATTGATATGC
52U	TTCTCTGGCGATCCTCCGCTTATTGATATGC
54U	TTCTCCATCGATCCTCCGCTTATTGATATGC
72T	TTCTCCGCTGATCCTCCGCTTATTGATATGC
57U	TTCTCGTGAGATCCTCCGCTTATTGATATGC
58U	TTCTGTGTAGATCCTCCGCTTATTGATATGC
59U	TTCTGAACCGATCCTCCGCTTATTGATATGC
23T	TTCTGACGTGATCCTCCGCTTATTGATATGC
24T	TTCTGCTCAGATCCTCCGCTTATTGATATGC
27T	TTCATTGTGGATCCTCCGCTTATTGATATGC
28T	TTCATCTTCGATCCTCCGCTTATTGATATGC
29T	TTCATGTCAGATCCTCCGCTTATTGATATGC
31T	TTCAGTTACGATCCTCCGCTTATTGATATGC
32TU	TTCAGTCCTGATCCTCCGCTTATTGATATGC
33TU	TTCAGATTGGATCCTCCGCTTATTGATATGC
35TU	TTCAGAAGAGATCCTCCGCTTATTGATATGC
36TU	TTCAGCTGTGATCCTCCGCTTATTGATATGC
38TU	TTCAGGCTAGATCCTCCGCTTATTGATATGC
39TU	TTCCTTCATGATCCTCCGCTTATTGATATGC
67T	TTCCTAATGGATCCTCCGCTTATTGATATGC