X7	TTGATCAACGTGTG
X8	TTGAGGACAGTGTG
X10	TTGGTGCCAGTGTG
X11	TATAGAGGTGTGTG
X13	TTCTCTTGTGTGTG
X14	TTCAAGAGAGTGTG
X16	TTCGTGATCGTGTG
X17	TTGTCTTCAGTGTG
X19	TTGATGAGGGTGTG
X20	TTGCATAAGGTGTG
X22	TTGGAACTTGTGTG
X23	TATAGCAACGTGTG
X25	TTCTCTAACGTGTG
X26	TTCAAGGTTGTGTG
X28	TTCGATGTGGTGTG
X29	TTGTCTCTTGTGTG
X31	TTGAACTCAGTGTG
X32	TTGCATGTTGTGTG
X34	TTGGACATAGTGTG
X35	TATAGGATGGTGTG